----w-Aw
----w--w
----w-w-
-----e--
--------
--------
