--------
--------
-w------
-----eA-
--------
--------
