wwwwwwwwwwwwwwww
ww-----www----ew
ww-www-www-wwwww
ww-w-w-------wtw
ww-w-wwww-wwww-w
w--------------w
w-wwww------wwww
w--------------w
w-----------ww-w
w--------------w
w----------www-w
w-w--------wwwww
wA------t------w
wwwwwwwwwwwwwwww